    if (this.#parent === null) {
      return;
    }
    this.#mapping.get(id).remove();
    this.#mapping.delete(id);
  }
  destroy() {
    this.#parent = null;
    for (const root of this.#mapping.values()) {
      root.remove();
    }
    this.#mapping.clear();
    this.#toUpdate.clear();
  }
}

;// ./src/pdf.js
















{
  globalThis._pdfjsTestingUtils = {
    HighlightOutliner: HighlightOutliner
  };
}
globalThis.pdfjsLib = {
  AbortException: AbortException,
  AnnotationEditorLayer: AnnotationEditorLayer,
  AnnotationEditorParamsType: AnnotationEditorParamsType,
  AnnotationEditorType: AnnotationEditorType,
  AnnotationEditorUIManager: AnnotationEditorUIManager,
  AnnotationLayer: AnnotationLayer,
  AnnotationMode: AnnotationMode,
  AnnotationType: AnnotationType,
  applyOpacity: applyOpacity,
  build: build,
  ColorPicker: ColorPicker,
  createValidAbsoluteUrl: createValidAbsoluteUrl,
  CSSConstants: CSSConstants,
  DOMSVGFactory: DOMSVGFactory,
  DrawLayer: DrawLayer,
  FeatureTest: util_FeatureTest,
  fetchData: fetchData,
  findContrastColor: findContrastColor,
  getDocument: getDocument,
  getFilenameFromUrl: getFilenameFromUrl,
  getPdfFilenameFromUrl: getPdfFilenameFromUrl,
  getRGB: getRGB,
  getUuid: getUuid,
  getXfaPageViewport: getXfaPageViewport,
  GlobalWorkerOptions: GlobalWorkerOptions,
  ImageKind: util_ImageKind,
  InvalidPDFException: InvalidPDFException,
  isDataScheme: isDataScheme,
  isPdfFile: isPdfFile,
  isValidExplicitDest: isValidExplicitDest,
  MathClamp: MathClamp,
  noContextMenu: noContextMenu,
  normalizeUnicode: normalizeUnicode,
  OPS: OPS,
  OutputScale: OutputScale,
  PasswordResponses: PasswordResponses,
  PDFDataRangeTransport: PDFDataRangeTransport,
  PDFDateString: PDFDateString,
  PDFWorker: PDFWorker,
  PermissionFlag: PermissionFlag,
  PixelsPerInch: PixelsPerInch,
  RenderingCancelledException: RenderingCancelledException,
  renderRichText: renderRichText,
  ResponseException: ResponseException,
  setLayerDimensions: setLayerDimensions,
  shadow: shadow,
  SignatureExtractor: SignatureExtractor,
  stopEvent: stopEvent,
  SupportedImageMimeTypes: SupportedImageMimeTypes,
  TextLayer: TextLayer,
  TouchManager: TouchManager,
  updateUrlHash: updateUrlHash,
  Util: Util,
  VerbosityLevel: VerbosityLevel,
  version: version,
  XfaLayer: XfaLayer
};

export { AbortException, AnnotationEditorLayer, AnnotationEditorParamsType, AnnotationEditorType, AnnotationEditorUIManager, AnnotationLayer, AnnotationMode, AnnotationType, CSSConstants, ColorPicker, DOMSVGFactory, DrawLayer, util_FeatureTest as FeatureTest, GlobalWorkerOptions, util_ImageKind as ImageKind, InvalidPDFException, MathClamp, OPS, OutputScale, PDFDataRangeTransport, PDFDateString, PDFWorker, PasswordResponses, PermissionFlag, PixelsPerInch, RenderingCancelledException, ResponseException, SignatureExtractor, SupportedImageMimeTypes, TextLayer, TouchManager, Util, VerbosityLevel, XfaLayer, applyOpacity, build, createValidAbsoluteUrl, fetchData, findContrastColor, getDocument, getFilenameFromUrl, getPdfFilenameFromUrl, getRGB, getUuid, getXfaPageViewport, isDataScheme, isPdfFile, isValidExplicitDest, noContextMenu, normalizeUnicode, renderRichText, setLayerDimensions, shadow, stopEvent, updateUrlHash, version };

//# sourceMappingURL=pdf.mjs.map