      learnMore: document.getElementById("altTextSettingsLearnMore"),
      deleteModelButton: document.getElementById("deleteModelButton"),
      downloadModelButton: document.getElementById("downloadModelButton"),
      showAltTextDialogButton: document.getElementById("showAltTextDialogButton"),
      altTextSettingsCloseButton: document.getElementById("altTextSettingsCloseButton"),
      closeButton: document.getElementById("altTextSettingsCloseButton")
    },
    addSignatureDialog: {
      dialog: document.getElementById("addSignatureDialog"),
      panels: document.getElementById("addSignatureActionContainer"),
      typeButton: document.getElementById("addSignatureTypeButton"),
      typeInput: document.getElementById("addSignatureTypeInput"),
      drawButton: document.getElementById("addSignatureDrawButton"),
      drawSVG: document.getElementById("addSignatureDraw"),
      drawPlaceholder: document.getElementById("addSignatureDrawPlaceholder"),
      drawThickness: document.getElementById("addSignatureDrawThickness"),
      imageButton: document.getElementById("addSignatureImageButton"),
      imageSVG: document.getElementById("addSignatureImage"),
      imagePlaceholder: document.getElementById("addSignatureImagePlaceholder"),
      imagePicker: document.getElementById("addSignatureFilePicker"),
      imagePickerLink: document.getElementById("addSignatureImageBrowse"),
      description: document.getElementById("addSignatureDescription"),
      clearButton: document.getElementById("clearSignatureButton"),
      saveContainer: document.getElementById("addSignatureSaveContainer"),
      saveCheckbox: document.getElementById("addSignatureSaveCheckbox"),
      errorBar: document.getElementById("addSignatureError"),
      errorTitle: document.getElementById("addSignatureErrorTitle"),
      errorDescription: document.getElementById("addSignatureErrorDescription"),
      errorCloseButton: document.getElementById("addSignatureErrorCloseButton"),
      cancelButton: document.getElementById("addSignatureCancelButton"),
      addButton: document.getElementById("addSignatureAddButton")
    },
    editSignatureDialog: {
      dialog: document.getElementById("editSignatureDescriptionDialog"),
      description: document.getElementById("editSignatureDescription"),
      editSignatureView: document.getElementById("editSignatureView"),
      cancelButton: document.getElementById("editSignatureCancelButton"),
      updateButton: document.getElementById("editSignatureUpdateButton")
    },
    annotationEditorParams: {
      editorCommentsSidebar: document.getElementById("editorCommentsSidebar"),
      editorCommentsSidebarCount: document.getElementById("editorCommentsSidebarCount"),
      editorCommentsSidebarTitle: document.getElementById("editorCommentsSidebarTitle"),
      editorCommentsSidebarCloseButton: document.getElementById("editorCommentsSidebarCloseButton"),
      editorCommentsSidebarList: document.getElementById("editorCommentsSidebarList"),
      editorCommentsSidebarResizer: document.getElementById("editorCommentsSidebarResizer"),
      editorFreeTextFontSize: document.getElementById("editorFreeTextFontSize"),
      editorFreeTextColor: document.getElementById("editorFreeTextColor"),
      editorInkColor: document.getElementById("editorInkColor"),
      editorInkThickness: document.getElementById("editorInkThickness"),
      editorInkOpacity: document.getElementById("editorInkOpacity"),
      editorStampAddImage: document.getElementById("editorStampAddImage"),
      editorSignatureAddSignature: document.getElementById("editorSignatureAddSignature"),
      editorFreeHighlightThickness: document.getElementById("editorFreeHighlightThickness"),
      editorHighlightShowAll: document.getElementById("editorHighlightShowAll")
    },
    printContainer: document.getElementById("printContainer"),
    editorUndoBar: {
      container: document.getElementById("editorUndoBar"),
      message: document.getElementById("editorUndoBarMessage"),
      undoButton: document.getElementById("editorUndoBarUndoButton"),
      closeButton: document.getElementById("editorUndoBarCloseButton")
    },
    editCommentDialog: {
      dialog: document.getElementById("commentManagerDialog"),
      toolbar: document.getElementById("commentManagerToolbar"),
      title: document.getElementById("commentManagerTitle"),
      textInput: document.getElementById("commentManagerTextInput"),
      cancelButton: document.getElementById("commentManagerCancelButton"),
      saveButton: document.getElementById("commentManagerSaveButton")
    }
  };
}
function webViewerLoad() {
  const config = getViewerConfiguration();
  const event = new CustomEvent("webviewerloaded", {
    bubbles: true,
    cancelable: true,
    detail: {
      source: window
    }
  });
  try {
    parent.document.dispatchEvent(event);
  } catch (ex) {
    console.error("webviewerloaded:", ex);
    document.dispatchEvent(event);
  }
  PDFViewerApplication.run(config);
}
document.blockUnblockOnload?.(true);
if (document.readyState === "interactive" || document.readyState === "complete") {
  webViewerLoad();
} else {
  document.addEventListener("DOMContentLoaded", webViewerLoad, true);
}

export { PDFViewerApplication, AppConstants as PDFViewerApplicationConstants, AppOptions as PDFViewerApplicationOptions };

//# sourceMappingURL=viewer.mjs.map